United Kingdom - Wiktionary, the free dictionary
United Kingdom
From Wiktionary, the free dictionary
Jump to navigation
Jump to search
Contents
1 English
1.1 Alternative forms
1.2 Etymology
1.3 Pronunciation
1.4 Proper noun
1.4.1 Synonyms
1.4.2 Translations
1.5 See also
English[edit]
English Wikipedia has an article on:United KingdomWikipedia 
Wikivoyage has an article on:
United Kingdom 
Wikivoyage 
Alternative forms[edit]
UK, U.K. (initialism)
Etymology[edit]
From united +‎ kingdom, first attested from 1706.
Pronunciation[edit]
(UK, US) IPA(key): /juːˌnaɪ.tɪd ˈkɪŋ.dəm/, /jʊˌnaɪ.tɪd ˈkɪŋ.dəm/, /jəˌnaɪ.tɪd ˈkɪŋ.dəm/
Audio (US)(file)
Hyphenation: Unit‧ed King‧dom
Proper noun[edit]
the United Kingdom
A kingdom and sovereign state in Western Europe comprising the four countries of England, Scotland and Wales on the island of Great Britain, and Northern Ireland on the northeastern portion of the island of Ireland since 1922.
(historical) The United Kingdom of Great Britain and Ireland (1801–1922).
(historical, informal, nonstandard) The Kingdom of Great Britain (1707–1801).
(nation's name) Kingdom consisting of several constituencies, actual, historical, or hypothetical.
the United Kingdom of Portugal, Brazil and the Algarves
Synonyms[edit]
(Sense 1): United Kingdom of Great Britain and Northern Ireland (official name), Great Britain (loosely), Britain (loosely), England (non-standard; sometimes offensive).
(Sense 3): Great Britain (official name), Kingdom of Great Britain (modern use)
Translations[edit]
sovereign state in Europe — see also Great Britain
Adyghe: Британиешхо Пачъыхьыгъо (Britaniješxʷo Paĉəḥəğʷo)
Afrikaans: Verenigde Koninkryk (af)
Albanian: Mbretëria e Bashkuar
Amharic: ዩናይትድ ኪንግደም (yunaytəd kingədäm)
Arabic: الْمَمْلَكَة الْمُتَّحِدَة‎ (ar) f (al-mamlaka l-muttaḥida)
Armenian: Միացյալ Թագավորություն (Miacʿyal Tʿagavorutʿyun)
Assyrian Neo-Aramaic: ܡܲܠܟܘܼܬܵܐ ܡܚܲܝܕܬܵܐ‎ (mālkuta mḳaydta)
Asturian: Reinu Xuníu (ast) m
Azerbaijani: Birləşmiş Krallıq
Bashkir: Берләшкән Короллеге (Berläşkän Korollege)
Basque: Erresuma Batua (eu)
Belarusian: Злу́чанае Карале́ўства n (Zlúčanaje Karaljéŭstva), Аб'ядна́нае Карале́ўства n (Abʺjadnánaje Karaljéŭstva)
Bengali: যুক্তরাজ্য (bn) (juktorajjo)
Breton: Rouantelezh Unanet
Bulgarian: Обедине́но кра́лство n (Obedinéno králstvo)
Burmese: ယူနိုက်တက်ကင်းဒမ်း (yunuiktakkang:dam:)
Catalan: Regne Unit (ca) m, Regne Unit de la Gran Bretanya i Irlanda del Nord m
Chinese:
Cantonese: 英國／英国 (jing1 gwok3), 大英聯合王國／大英联合王国 (daai6 jing1 lyun4 hap6 wong4 gwok3)
Mandarin: 英國／英国 (zh) (Yīngguó), 大不列顛及北愛爾蘭聯合王國／大不列颠及北爱尔兰联合王国 (zh) (Dà-Bùlièdiān jí Běi-Ài'ěrlán Liánhé Wángguó), 聯合王國／联合王国 (zh) (Liánhé Wángguó)
Czech: Spojené království (cs) n
Danish: Forenede Kongerige n
Dutch: Verenigd Koninkrijk (nl) n
Dzongkha: ཡུ་ནའི་ཊེཊ་ཀིང་ཌམ (yu na'i ṭeṭ king ḍam)
Esperanto: Unuiĝinta Regno, Unuiĝinta Reĝlando
Estonian: Ühendkuningriik (et) (only in diplomacy), Suurbritannia ja Põhja-Iiri Ühendkuningriik
Farefare: Ɩŋɔ
Faroese: Hitt Sameinda Kongsríki n
Finnish: Yhdistynyt kuningaskunta (fi)
French: Royaume-Uni (fr) m, Royaume-Uni de Grande-Bretagne et d’Irlande du Nord (fr) m
Galician: Reino Unido (gl) m
Georgian: გაერთიანებული სამეფო (ka) (gaertianebuli samepo)
German: Vereinigtes Königreich (de) n
Bavarian: Vaeinigte Kinireich
Greek: Ηνωμένο Βασίλειο (el) n (Inoméno Vasíleio)
Greenlandic: Tuluit Nunaat
Gujarati: યુનાઇટેડ કિંગડમ (yunāiṭeḍ kiṅgḍam)
Haitian Creole: Wayòm Ini
Hausa: Birtaniya (ha)
Hawaiian: Aupuni Mōʻī Hui Pū ʻia
Hebrew: הַמַמְלָכָה הַמְאֻחֶדֶת‎ (ha-mamlakha ha-meukhedet)
Hindi: यूनाइटेड किंगडम m (yūnāiṭeḍ kiṅgḍam), संयुक्त राजशाही (hi) m (sãyukt rājśāhī)
Hungarian: Egyesült Királyság (hu), Nagy-Britannia és Észak-Írország Egyesült Királysága (hu)
Icelandic: Hið sameinaða konungsríki n
Ido: Unionita Rejio (io)
Indonesian: Kerajaan Bersatu (but it is more often to be referred as Britania Raya (“Great Britain”)), Britania Raya (id), Inggris Raya (id), Inggris (id)
Interlingua: Regno Unite
Irish: An Ríocht Aontaithe (ga) f
Italian: Regno Unito (it) m, Regno Unito di Gran Bretagna e Irlanda del Nord (it) m
Japanese: 英国 (ja) (えいこく, Eikoku), イギリス (ja) (Igirisu), グレートブリテン及び北アイルランド連合王国 (ja) (Gurēto Buriten oyobi Kita Airurando rengō ōkoku), 連合王国 (ja) (れんごうおうこく, Rengō ōkoku)
Kalmyk: Ниицәтә Нутг (Niitsätä Nutg)
Kazakh: Біріккен Корольдік (Bırıkken Koroldık), Құрама Патшалық (Qūrama Patşalyq) (rare), Ұлыбритания және Солтүстік Ирландия Біріккен Корольдігі (Ūlybritaniä jäne Soltüstık İrlandiä Bırıkken Koroldıgı), Біріккен Патшалық (Bırıkken Patşalyq)
Khmer: ចក្រភពអង់គ្លេស (cakkraʼphup ʼɑngkleih), សហរាជាណាចក្រ (saʼhaʼriəciənaacak), រាជាណាចក្ររួម (km) (riəciənaacak ruəm)
Korean: 영국(英國) (ko) (Yeongguk), 그레이트브리튼 북아일랜드 연합 왕국 (Geureiteubeuriteun bugaillaendeu yeonhap wangguk), 연합 왕국 (Yeonhap wangguk), 대브리텐 및 북아일랜드 련합 왕국 (Daebeuriten mit bugaillaendeu ryeonhap wangguk) (North Korea), 련합 왕국 (Ryeonhap wangguk) (North Korea)
Kurdish:
Central Kurdish: شانشینی یەکگرتوو‎ (şanşînî yekgrtû)
Northern Kurdish: Keyaniya Yekbûyî (ku)
Kyrgyz: Бириккен Падышалык (Birikken Padışalık)
Lao: ສະຫະລາຊະອານາຈັກ (lo) (sa ha lā sa ʼā nā chak)
Latin: Rēgnum Ūnītum n, Britanniarum Regnum n
Latvian: Apvienotā Karaliste f, Lielbritānijas un Ziemeļīrijas Apvienotā Karaliste f
Lithuanian: Jungtinė Karalystė (lt)
Macedonian: Обединето Кралство (mk) n (Obedineto Kralstvo)
Malay: United Kingdom
Malayalam: യുണൈറ്റഡ് കിങ്ഡം (yuṇaiṟṟaḍŭ kiṅḍaṁ)
Maltese: Renju Unit, Ir-Renju Unit tal-Gran Brittanja u l-Irlanda ta’ Fuq
Marathi: युनायटेड किंग्डम (yunāyṭeḍ kiṅgḍam)
Mingrelian: გოართოიანაფილი ომაფე (goartoianapili omape)
Mongolian:
Cyrillic: Нэгдсэн Вант улс (Negdsen Vant uls)
Navajo: Tótaʼ Dineʼé Bikéyah
Nepali: संयुक्त अधिराज्य (samyukta adhirājya)
Norman: Le Rouoyaume Unni m
North Frisian: Feriind Kiningrik
Northern Sami: Ovttastuvvan gonagasriika
Norwegian:
Bokmål: Det forente kongerike Storbritannia og Nord-Irland n
Nynorsk: Det sameinte kongeriket Storbritannia og Nord-Irland n
Occitan: Reialme Unit (oc) m, Reiaume Unit m
Ossetian: Иугонд Паддзахад (Iwgond Padʒaxad)
Pashto: د سترې بریتانيې او شمالي ايرلينډ متحد سلطنت‎ (da sathre bareethanye aw shamalai ieralaend mathhd salathnth)
Persian: پادِشاهیِ مُتَّحِد‎ (pâdešâhi-ye mottahed)
Polish: Zjednoczone Królestwo (pl) n
Portuguese: Reino Unido (pt) m, Reino Unido da Grã-Bretanha e Irlanda do Norte m
Punjabi: ਸੰਯੁਕਤ ਬਾਦਸ਼ਾਹੀ (sãyukat bādśāhī)
Quechua: Hukllachasqa Qhapaq Suyu
Rarotongan: Paratāne
Romanian: Regatul Unit al Marii Britanii și Irlandei de Nord n, Regatul Unit (ro) n
Russian: Великобрита́ния (ru) (Velikobritánija), Соединённое Короле́вство n (Sojedinjónnoje Korolévstvo), Соединённое Короле́вство Великобрита́нии и Се́верной Ирла́ндии n (Sojedinjónnoje Korolévstvo Velikobritánii i Sévernoj Irlándii)
Rusyn: Велика Брітанія n (Velyka Britanija), Споєне кралёвство Великой Брітанії і Северного Ірьска n (Spojene kraljovstvo Velykoj Britaniji i Severnoho Irʹska)
Samoan: Iunaite Malo
Scots: Unitit Kinrick, Unitit Kinrick o Greet Britain an Norlin Airlann
Scottish Gaelic: An Rìoghachd Aonaichte f, Rìoghachd Aonaichte na Breatainn Mhòr agus Eirinn a Tuath f
Serbo-Croatian:
Cyrillic: Уједињено Краљевство n, Уједињено Краљевство Велике Британије и Сјеверне Ирске n
Roman: Ujedinjeno Kraljevstvo n, Ujedinjeno Kraljevstvo Velike Britanije i Sjeverne Irske n
Sicilian: Regnu Unitu m, Regnu Unitu dâ Britagna Granni e di l'Irlanna dû Norti m
Silesian: Zjydnoczůne Krůlestwo Wjelgij Brytańije i Irlandyje Půłnocny n (literal translation of the full name), (colloquially:) Yngland m, Anglijo f
Sindhi: گڏيل بادشاھت‎
Sinhalese: එක්‍සත් රාජධානිය (eksat rājadhāniya)
Slovak: Spojené kráľovstvo n, Spojené kráľovstvo Veľkej Británie a Severného Írska (sk) n
Slovene: Zdrúženo kraljéstvo (sl) n
Somali: Midowga boqortooyada
Sorbian:
Lower Sorbian: Zjadnośone kralojstwo
Upper Sorbian: Zjednoćene kralestwo
Spanish: Reino Unido (es) m, Reino Unido de Gran Bretaña e Irlanda del Norte m
Swahili: Ufalme wa Muungano
Swedish: Förenade kungariket (sv) n
Tagalog: Reyno Unido
Tajik: Подшоҳии Муттаҳида (tg) (Podšohiyi Muttahida)
Tamil: ஐக்கிய இராச்சியம் (ta) (aikkiya irācciyam), ஐக்கிய இராச்சியத்தில் (aikkiya irācciyattil)
Tatar: Берләшкән Патшалык (Berläşkän Patşalıq)
Telugu: యునైటెడ్ కింగ్‌డమ్ (te) (yunaiṭeḍ kiṅg‌ḍam)
Thai: สหราชอาณาจักร (th) (sà-hà-râat-chá-aa-naa-jàk)
Tibetan: དབྱིན་ཇི་རྒྱལ་ཕྲན་གཅིག་སྡུད (dbyin ji rgyal phran gcig sdud)
Turkish: Birleşik Krallık (tr)
Turkmen: Birleşen Patyşalyk
Ukrainian: Сполу́чене Королі́вство n (Spolúčene Korolívstvo)
Urdu: مَمْلَکَتِ مُتَّحِدَہ‎ (mamlakat-i muttahidā), یونائٹِڈ کِنگڈَم‎ m (yūnāiṭeḍ kiṅgḍam)
Uyghur: بۈيۈك برىتانىيە ۋە شىمالىي ئىرلاندىيە بىرلەشمە پادىشاھلىقى‎ (büyük britaniye we shimaliy irlandiye birleshme padishahliqi)
Uzbek: Birlashgan Qirollik (uz)
Vietnamese: Vương quốc Anh (vi), Anh Quốc (vi) (英國)
Võro: Ühendkuningriik
Welsh: Y Deyrnas Unedig f, Y Deyrnas Gyfunol f
West Frisian: Feriene Keninkryk
Yiddish: פֿאַראייניקט קעניגרײַך‎ n (fareynikt kenigraykh)
Yoruba: Orílẹ́ède Omobabirin
Zhuang: Yinghgoz
See also[edit]
(countries of Europe) country of Europe; Albania, Andorra, Armenia, Austria, Azerbaijan, Belarus, Belgium, Bosnia and Herzegovina, Bulgaria, Croatia, Cyprus, Czech Republic, Denmark, Estonia, Finland, France, Georgia, Germany, Greece, Hungary, Iceland, Ireland, Italy, Kazakhstan, Latvia, Liechtenstein, Lithuania, Luxembourg, Malta, Moldova, Monaco, Montenegro, Netherlands, North Macedonia, Norway, Poland, Portugal, Romania, Russia, San Marino, Serbia, Slovakia, Slovenia, Spain, Sweden, Switzerland, Turkey, Ukraine, United Kingdom, Vatican City
Countries of the world
Retrieved from "https://en.wiktionary.org/w/index.php?title=United_Kingdom&oldid=75797527"
Categories: English compound termsEnglish terms with IPA pronunciationEnglish terms with audio linksEnglish lemmasEnglish proper nounsEnglish multiword termsEnglish terms with historical sensesEnglish informal termsEnglish nonstandard termsEnglish terms with usage examplesen:Countries in Europeen:United KingdomHidden categories: English entries with topic categories using raw markupTerms with manual transliterations different from the automated onesTerms with manual transliterations different from the automated ones/arTerms with manual transliterations different from the automated ones/aiiTerms with manual transliterations different from the automated ones/ckbTerms with manual transliterations different from the automated ones/ur
Navigation menu
Personal tools
Not logged inTalkContributionsCreate accountLog in
Namespaces
EntryDiscussion
English
Views
ReadEditHistory
More
Search
Navigation
Main PageCommunity portalPreferencesRequested entriesRecent changesRandom entryHelpGlossaryDonationsContact us
Tools
What links hereRelated changesUpload fileSpecial pagesPermanent linkPage informationCite this page
Print/export
Create a bookDownload as PDFPrintable version
In other languages
العربيةAsturianuAzərbaycancaবাংলাBân-lâm-gúČeštinaDanskDeutschEestiΕλληνικάEspañolFrançaisGalego한국어हिन्दीHrvatskiBahasa IndonesiaItalianoಕನ್ನಡქართულიҚазақшаKurdîລາວLatviešuLietuviųMagyarMaltiNederlands日本語Norsk nynorskOromooOʻzbekcha / ўзбекчаភាសាខ្មែរPolskiPortuguêsRomânăРусскийShqipSimple EnglishSlovenčinaСрпски / srpskiSuomiSvenskaதமிழ்ไทยТоҷикӣTürkçeTiếng Việt中文
 This page was last edited on 27 August 2023, at 01:24.
Definitions and other text are available under the Creative Commons Attribution-ShareAlike License; additional terms may apply. By using this site, you agree to the Terms of Use and Privacy Policy.
Privacy policy
About Wiktionary
Disclaimers
Code of Conduct
Mobile view
Developers
Statistics
Cookie statement