bird - Wiktionary, the free dictionary
bird
From Wiktionary, the free dictionary
Jump to navigation
Jump to search
See also: Bird and bÃ­rd
Contents
1 English
1.1 Pronunciation
1.2 Etymology 1
1.2.1 Noun
1.2.1.1 Synonyms
1.2.1.2 Hyponyms
1.2.1.3 Derived terms
1.2.1.4 Descendants
1.2.1.5 Translations
1.2.1.6 See also
1.2.2 Verb
1.2.3 Adjective
1.3 Etymology 2
1.3.1 Noun
1.3.1.1 Synonyms
1.3.1.2 Translations
1.3.2 Verb
1.3.2.1 Translations
1.4 References
1.5 Anagrams
English[edit]
 Â Bird (disambiguation) on Wikipedia
Picture dictionary
bird
bird of preybird of prey
parrotparrot
passerinepasserine
ratiteratite
seabirdseabird
shorebirdshorebird
waterfowlwaterfowl
Pronunciation[edit]
(Received Pronunciation) enPR: bÃ»(r)d, IPA(key): /bÉœËd/
(General American) IPA(key): /bÉd/, [bÉÉ–]
(NYC, Southern American English, dated) IPA(key): [bÉ™Éªd]
Audio (US)(file)
(General Australian) enPR: bÃ»(r)d, IPA(key): /bÉ˜Ëd/
(Indian English) IPA(key): /bÉœd/
Rhymes: -ÉœË(É¹)d
Etymology 1[edit]
From Middle English brid, from Old English bridd (â€œchick, baby birdâ€), of uncertain origin and relation; but its stock root is possibly onomatopoeic. Gradually replaced fowl as the most common term starting in the 14th century.
The "booing/jeering" and "vulgar hand gesture" senses derived from the expression â€œto give the big birdâ€, as in â€œto hiss someone like a gooseâ€, dated in the midâ€18th Century.
Noun[edit]
bird (plural birds)
A member of the class of animals Aves in the phylum Chordata, characterized by being warm-blooded, having feathers and wings usually capable of flight, having a beaked mouth, and laying eggs.
Ducks and sparrows are birds.
2004, Bruce Whittington, Loucas Raptis, Seasons with Birds, page 50:The level below this is called the Phylum; birds belong to the Phylum Chordata, which includes all the vertebrate animals (the sub-phylum Vertebrata) and a few odds and ends.
(cooking, slang) A chicken or turkey used as food.
Pitch in and help me stuff the bird if you want Thanksgiving dinner.
(slang) A man, fellow. [from mid-19th c.]
1886, Edmund Routledge, Routledge's every boy's annual:He once took in his own mother, and was robbed by a 'pal,' who thought he was a doctor. Oh, he's a rare bird is 'Gentleman Joe'!
1925 July â€“ 1926 May, A[rthur] Conan Doyle, â€œ(please specify the chapter number)â€, in The Land of Mist (eBook no. 0601351h.html), Australia: Project Gutenberg Australia, published April 2019:"What I mean - I expect that old, red-headed bird at the office sent you round with no other purpose."
1939, Raymond Chandler, The Big Sleep, Penguin, published 2011, page 24:The door opened and a tall hungry-looking bird with a cane and a big nose came in neatly, shut the door behind him against the pressure of the door closer, marched over to the desk and placed a wrapped parcel on the desk.
2006, Jeff Fields, Terry Kay, A cry of angels:"Ah, he's a funny bird," said Phaedra, throwing a leg over the sill.
(UK, Ireland, slang) A girl or woman, especially one considered sexually attractive.
1809, Thomas Campbell, Lord Ullin's Daughter:And by my word! the bonny bird / In danger shall not tarry.
1918 [1915], Thomas Burke, Nights in Londonâ€[1], New York: Henry Holt and Company, page 75:After tea, the bright boys wash, clean their boots, and change into their â€œsecond-bestâ€ attire, and stroll forth [â€¦] ; sometimes to saunter, in company with others, up and down that parade until they â€œclickâ€ with one of the â€œbirds.â€
2013 September 13, Russell Brand, The Guardianâ€[2]:The usual visual grammar was in place â€“ a carpet in the street, people in paddocks awaiting a brush with something glamorous, blokes with earpieces, birds in frocks of colliding colours that if sighted in nature would indicate the presence of poison.
2017, David Weigel, The Show That Never Ends: The Rise and Fall of Prog Rock, W. W. Norton & Company:â€œAll these fantastic birds, long hair, made up, false eyelashes and things, crowding round this group of scabby, spotty teenagers,â€ marveled Anderson.
(UK, Ireland, slang) A girlfriend. [from early 20th c.]
Mike went out with his bird last night.
2002, â€œGeezers need excitementâ€, in Mike Skinner (lyrics), Original Pirate Material, performed by The Streets:But all of a sudden though, just through the smoke / It's your bird laughing and joking with a bloke / Ain't just that either, as she moves closer / In a shape what looks like they're lovers, he's tonguing her!
(slang) An airplane.
2007 September 25, Bungie, Halo 3, v1.0, Microsoft Game Studios, [[:w:Xbox 360, level/area: [https://www.halopedia.org/Crow's_Nest Crow's Nest]|Xbox 360, level/area: [https://www.halopedia.org/Crow's_Nest Crow's Nest]]]:Any of our birds squawking?
(slang) A satellite.
1988, Satellite communications. Jan-Oct. 1988:Deployment of the fourth bird "should ensure that Inmarsat has sufficient capacity in orbit in the early 1990s, taking into account the possibility of launch failures and the age of some of the spacecraft in the Inmarsat first generation system
1992, Cable Vision:Will a government- backed APSTAR satellite knock out a planned AsiaSat II bird?
2015, John Fuller, Thor's Legions: Weather Support to the U.S. Air Force and Army, 1937-1987, Springer, â†’ISBN, page 384:In reality, the Air Force was never able to place a bird in orbit that quickly.
(obsolete) A chicken; the young of a fowl; a young eaglet; a nestling.
c. 1597 (date written), William Shakespeare, â€œThe First Part of Henry the Fourth,Â [â€¦]â€, in Mr. William Shakespeares Comedies, Histories, & TragediesÂ [â€¦] (First Folio), London:  [â€¦]  Isaac Iaggard, and Ed[ward] Blount, published 1623, â†’OCLC, [Act V, scene i]:That ungentle gull, the cuckoo's bird.
1494â€“1536, William Tyndale, Bible, Matthew 8:20
The brydds [birds] of the aier have nestes.
(UK, with definite article, especially in expressions such as 'give someone the bird') Booing and jeering, especially as done by an audience expressing displeasure at a performer.
(with definite article) The vulgar hand gesture in which the middle finger is extended.
Synonym: the finger
2002, The Advocate, "Flying fickle finger of faith", page 55.
For whatever reason â€” and there are so many to chose from â€” they flipped the bird in the direction of the tinted windows of the Bushmobile.
2003, James Patterson, Peter de Jonge, The Beach House, Warner Books, page 305:Then she raised both hands above her shoulders and flipped him the bird with each one.
A yardbird.
(slang, US) A kilogram of cocaine.
Synonyms: chicken, brick
2015 January 12, Lil Wayne (lyrics and music), â€œSh!tâ€ (track 2), in Sorry 4 the Wait 2â€[3]:Never dirt on my kneesI'm just serving these fiendsSell birds to the beesI sell birds to the trees
(slang, Canada, Philippines) A penis.
2004 May 9, Mike Clattenburg, Mike Smith (actor), 05:29 from the start, in Trailer Park Boys(Conky), season 4, episode 5 (TV series), spoken by Bubbles (Mike Smith):BUBBLES: One time I was making a model and I glued the wing to a B17 bomber to my bird by accident.
Synonyms[edit]
(member of class Aves): fowl, avian, (idiomatic) feathered friend, (collectively) feathered folk
(man): chap, bloke, guy
(woman): broad, chick, dame, girl, lass
See also Thesaurus:woman
See also Thesaurus:girl
Hyponyms[edit]
See also Thesaurus:bird
Derived terms[edit]
a bird in the hand is worth two in the busha little bird told mebanana birdband birdsbarley-birdbeach birdsbill-birdbill birdbirdaholicbird aircraft strike hazard (BASH)bird appbird ballbird bathbirdbeak dogfish (Deania calcea)birdboltbirdboxbirdbrain, bird brainbirdbrained, bird-brainedbird breeder's lungbird burstbird-cagebirdcagebirdcage clockbirdcall, bird-call, bird callbirdcallerbirdcall imitation, bird-call imitation, bird call imitationbirdcall imitator, bird-call imitator, bird call imitatorbirdcallingbirdcarebirdcatcher, bird-catcher, bird catcherbirdcatching, bird-catching, bird catchingbird-catching netbird cherrybird-cherry erminebird chorusbird cliffbird colonelbird colonybird coursebirdcrapbird dealer, bird-dealerbird-dobird dog, bird-dog, bird-dogged, bird-doggingbirddombird droppingsbird dropping spiderbirdeaterbirdeenbirderbird eyebird-eyedbird fancier's lungbirdfeedbird feeder, birdfeederbirdfestbird flubirdfood, bird foodbird-footbird-footed dinosaurbirdfuckerbird-hatchingbird-headedbird hidebird-hippedbird-hipped dinosaurbirdhoodbirdhouse, bird-house, bird housebirdie, birdied, birdieingbirdikinbirdinessbird influenzabirdingbird ingestionbird in the bosombird in the hand, bird in handbirdishbirdkeeperbirdkindbirdlessbirdletbirdlifebirdlike, bird-likebirdlime, birdlimed, birdlimingbirdlimerbirdlingbirdlorebird lousebirdlover, bird-lover, bird loverbirdloving, bird-loving, bird lovingbirdlybirdmanbirdmombirdnap, birdnapperbirdnessbird-nestbirdnest, birdnestingbird-nestingbirdobird of freedombird of ill omenbird of Jovebird of Junobird of one's own brainbird of paradise, bird-of-paradisebird-of-paradise flowerbird of passagebird of peacebird of preybird of wonderbird pepperbirdproofbird-richbirds and beesbirdseedbirdseller, bird-sellerbird's eyebird's-eye mapbird's-eye maple, bird's eye maple (Acer saccharum)bird's-eye primrosebird's-eye speedwellbird's-eye viewbird's-footbird's-foot trefoilbird's-foot violetbird shitbirdshitbirdshot, bird shotbirdsitbirdsmouthbird's-nest orchidbird's-nest soup, bird's nest soupbirds of a feather, birds of a feather flock togetherbirds of paradise, birds-of-paradisebirdsomebird songbirdsongbird spiderbird's toothbirdstore, bird storebirdstrike, bird strikebird stufferBirds' Weddingbirdsweetbird tablebirdtrapbird-walkbirdwalkbird walkbirdwatcherbirdwatchingbirdweedbirdwingbirdwisebird-wittedbirdwomanbirdyboatswain-birdbovver birdbower birdbroken birdbunyip birdbutcher birdcage birdcall birdcanary birdcat birdcedar birdcharm a bird off a branchchipping birdclever birdcock bird, cock-birdcockyolly birdcockyoly birdcrocodile birdcrying birddead birddevil birddiamond birddickeybird, dickybirddicky birddicky-birddo birddoctor birddodo birddolly-birddolly birddragoon birddrinking birdearly birdearly bird catches the wormearly bird specialeat like a birdegg-birdelephant birdEuropean bird cherryfeathered oof-birdfine feathers make fine birdsflip the birdfor the birdsfree as a birdfriar birdfrigatebird, frigate birdfull bird colonelfunny birdgallows-birdgallows birdgamebird, game birdgamebird farmer, game-bird farmergaol-birdgay old birdget the birdghetto birdgive somebody the bird, give someone the birdgive the birdglacier birdgo-away-birdgo-away birdGoliath birdeatergooney birdgospel birdgo the way of the dodo birdhen birdhummingbird, humming-bird, humming birdimportant bird areainvisible birdiron birdit's an ill bird that fouls its own nestjail birdjail-birdkill two birds with one stonelady-birdlettuce-birdlife birdlightning birdlike a birdlittle birdliver birdLord God birdlove birdmackerel birdmallee birdman-birdmango birdmango-birdmigratory birdmino birdmockingbirdmocking birdmother-birdmutton birdnaked as a jay birdnaked as a jay-birdnight birdodd birdold birdoof-birdoozlum birdpaddy birdparson birdPeabody birdperching birdpie birdpoÃ«-bird, poÃ« bird, poebirdpreacher birdqua-birdqueer birdrare birdregent-birdrhinoceros birdsankofa birdscape-birdscrub birdsea birdseabirdseal-birdsecretary birdshit birdshoot a birdshorebird, shore birdsing like a birdskipper-birdsnow birdsnow-birdspokesbirdstorm-birdstrange birdStymphalian birdsultana birdT-birdterror birdthe bird has flown, the bird is flownthe birds and the beesthe early bird catches the wormthe early bird gets the wormtoddy birdumbrella birdunicorn birdwading birdwaterbird, water birdwhore's-birdwidow birdyard birdyawker birdyear-birdyellow-birdÂ 
Descendants[edit]
â†’ Esperanto: birdo
Translations[edit]
animal
Abenaki: sips
Abkhaz: Ğ°Ô¥ÑĞ°Ğ° (apsaa)
Abu: ungaraka
Acehnese: cicÃ©m
Adyghe: Ğ±Ğ·Ñ‹Ñƒ (bzÉ™wu)
Afar: kimbirÃ³Â f
Afrikaans: voÃ«lÂ (af)
Ahom: ğ‘œƒğ‘œ¤ğ‘œ€ğ‘œ« (nuk)
Ainu: ãƒã‡¼ (cir)
Aiton: please add this translation if you can
Alangan: punay
Albanian: zogÂ (sq)Â m
Aleut: sax
Ama: uo
Amharic: á‹ˆá (wÃ¤f)
Apache:
Western Apache: diÇ«', izhÃ¡she, izhÃ¡she
Arabic: Ø·ÙØ§Ø¦ÙØ±â€Â (ar)Â m (á¹­ÄÊ”ir), Ø¹ÙØµÙ’ÙÙÙˆØ±â€Â m (Ê•uá¹£fÅ«r)
Egyptian Arabic: Ø·ÙŠØ±â€Â m (á¹­Ä“r) (zoological), Ø¹ØµÙÙˆØ±Ø©â€Â f (Ê•aá¹£fÅ«ra)
Hijazi Arabic: Ø·ÙŠØ±â€Â m (á¹­Ä“r), Ø¹ÙØµÙ’ÙÙˆØ±â€Â m (Ê•aá¹£fÅ«r)
Iraqi Arabic: Ø·ÙŠØ±â€ (á¹­Ä«r)
Lebanese Arabic: Ø¹ØµÙÙˆØ±Ø©â€ (Ê•aá¹£fÅ«re)
Algerian Arabic: Ø²Ø§ÙˆØ´â€ (zÄwÉ™Å¡)
Moroccan Arabic: Ø¨Ø±Ø·Ø§Ù„â€ (bÉ˜rá¹­Äl)
Aragonese: paxaroÂ m
Archi: Ğ½Ğ¾Ñ†Ó (nocÊ¼)
Armenian: Õ©Õ¼Õ¹Õ¸Ö‚Õ¶Â (hy) (tÊ¿á¹™ÄÊ¿un), Õ®Õ«Õ¿Â (hy) (cit), Õ°Õ¡Õ¾Ö„Â (hy) (havkÊ¿)
Aromanian: puljÂ m, puljiuÂ m, puljuÂ m
Assamese: à¦šà§°à¦¾à¦‡ (sorai)
Assyrian Neo-Aramaic: Ü›Ü²ÜÜªÜµÜâ€Â m (á¹­ayra)
Asturian: pÃ¡xaruÂ (ast)Â m, aveÂ (ast)Â f
Avar: Ñ…ÓĞ¸Ğ½Ñ‡Ó (á¸¥Ê³inÄÊ¼)
Avestan: ğ¬¬ğ¬ğ¬±â€ (vÄ«Å¡), ğ¬¨ğ¬†ğ¬­ğ¬†ğ¬–ğ¬€â€ (mÉ™rÉ™Î³a)
Aymara: jamach'i
Azerbaijani: quÅŸÂ (az)
Bahnar: sem
Baluchi: Ù…Ø±Ú¯â€ (murg)
Bashkir: Ò¡Ğ¾Ñˆ (qoÅŸ)
Basque: txoriÂ (eu), hegaztiÂ (eu)
Bau Bidayuh: manuk
Belarusian: Ğ¿Ñ‚ÑƒÌÑˆĞºĞ°Â (be)Â f (ptÃºÅ¡ka), Ğ¿Ñ†Ñ–ÌÑ†Ğ°Â f (pcÃ­ca) (dated)
Bengali: à¦ªà¦¾à¦–à§€Â (bn) (pakhi)
Bikol Central:
Bikol Legazpi: bayongÂ (bcl)
Bikol Naga: gamgamÂ (bcl)
Blagar: uul
Bodo: à¤¦à¤¾à¤µ (dao)
BorÃ´ro: kiogÃ¶
Breton: labousÂ (br)Â m, evnÂ (br)Â m
Buginese: dongi
Bulgarian: Ğ¿Ñ‚Ğ¸ÌÑ†Ğ°Â (bg)Â f (ptÃ­ca)
Burmese: á€„á€¾á€€á€ºÂ (my) (hngak)
Catalan: auÂ (ca)Â m (taxonomic group), ocellÂ (ca)Â m, aucellÂ m, pardalÂ (ca)
Cebuano: langgam
Central Atlas Tamazight: â´°â´³â´¹âµ‰â´¹Â m (agá¸iá¸)
Central Melanau: manuok
Central Sierra Miwok: ÄÃ­Äka-
Cham:
Eastern Cham: ê¨Œê¨³ê¨ªê©Œ (chiim)
Western Cham:  please add this translation if you can
Chamicuro: chisti
Chechen: Ğ¾Ğ»Ñ…Ğ°Ğ·Ğ°Ñ€ (olxazar)
Chepang: à¤µà¤¾à¤ƒ
Cherokee: á¥áá†Â (chr) (tsisqua)
Cheyenne: vÃ©'kÃ©se
Chichewa: mbalame
Chichonyi-Chidzihana-Chikauma: mnyama
Chinese:
Cantonese: é›€ä»” (zoek3 zai2), é›€ (zoek3), é³¥ï¼é¸Ÿ (niu5)
Dungan: Ñ‡Ñ‘Ñ€ (ÄiÍ¡or), Ñ‡Ñ‘Ñ‡Ñ‘Ğ·Ñ‹ (ÄiÍ¡oÄiÍ¡ozÉ¨) (small), Ñ„Ğ¸Ğ½Ñ‘ (finiÍ¡o), Ñ„Ğ¸Ñ‡Ğ¸Ğ½ (fiÄin)
Hakka: é³¥å­ï¼é¸Ÿå­ (tiÃ¢u-chá¹³Ì), é³¥ï¼é¸Ÿ (tiÃ¢u), é³¥ä»”ï¼é¸Ÿä»” (tiÃ¢u-Ã©)
Mandarin: é³¥ï¼é¸ŸÂ (zh) (niÇo), é›€Â (zh) (quÃ¨)
Min Bei: éš»ä»”ï¼åªä»” (ciÄƒ-ciÄ›)
Min Dong: é³¥ï¼é¸Ÿ (cÄ“u), é³¥ä»”ï¼é¸Ÿä»” (cÄ“u-giÄng)
Min Nan: é³¥ï¼é¸ŸÂ (zh-min-nan) (chiÃ¡u / niÃ¡u), é³¥ä»”ï¼é¸Ÿä»”Â (zh-min-nan) (chiÃ¡u-Ã¡)
Wu: é³¥ï¼é¸Ÿ
Xiang: é³¥ï¼é¸Ÿ (nyau3)
Chukchi: Ğ³Ğ°Ñ‚Ô“Ğµ (gatá¸·e)
Chuukese: machang
Chuvash: ĞºĞ°Ğ¹Ó‘Ğº (kajÄƒk)
Cimbrian: bÃ³oghel, vogl
Coptic: Ï©â²â²—â²â²§ (halÄ“t)
Cornish: edhenÂ (kw)Â f
Corsican: acedduÂ (co)Â m
Cree: pileshish, peepee
Crimean Tatar: quÅŸ
Czech: ptÃ¡kÂ (cs)Â m
Dalmatian: paserainÂ m
Danish: fuglÂ (da)Â c
Dargwa: Ğ°Ñ€Ñ†Ğ°Ğ½ (arcan)
Darkinjung: dyipping
Daur: degii, deyii
Deori: à¦¦à§à§±à¦¾
Dhivehi: Ş‹Ş«Ş‚Ş¨â€Â (dv) (dÅ«ni)
Dolgan: ĞºÓ©Ñ‚Ó©Ñ€
Drung: pvchiq
Dutch: vogelÂ (nl)Â m
Dzongkha: à½–à¾± (bya)
Eastern Arrernte: thipe
Egyptian:      (êœ£pd)
Elfdalian: fugelÂ m
Erzya: Ğ½Ğ°Ñ€Ğ¼ÑƒĞ½ÑŒ (narmuÅ„)
Esperanto: birdoÂ (eo), birdeto (diminutive)
Estonian: lindÂ (et)
Even: Ğ´ÑĞ³Ğ¸ (dÉ™gi)
Evenki: Ğ´ÑĞ³Ğ¸ (dÉ™gi)
Ewe: xevi
Faroese: fuglurÂ (fo)Â m
Fataluku: olo
Fijian: mahumanuÂ (fj)
Finnish: lintuÂ (fi)
Franco-ProvenÃ§al: usÃ©lÂ m
French: oiseauÂ (fr)Â m, oiselleÂ (fr)Â f (female, poetic), oiseletÂ (fr)Â m (diminutive, literary), oisillonÂ (fr)Â m (diminutive)
Friulian: ucielÂ m, ucel
Galician: paxaroÂ (gl)Â m, aveÂ (gl)Â f
Gallo: ouÃ©zaiÂ m
Gamilaraay: dhigaraa
Ge'ez: á‹–á (Ê¿of)
Georgian: áƒ¤áƒ áƒ˜áƒœáƒ•áƒ”áƒšáƒ˜ (prinveli), áƒ©áƒ˜áƒ¢áƒ˜ (Äiá¹­i)
German: VogelÂ (de)Â m, VÃ¶gelchenÂ (de)Â n (diminutive), VÃ¶geleinÂ (de)Â n (diminutive, chiefly poetic), VÃ¶gleinÂ (de)Â n (diminutive)
Alemannic German: VogelÂ m
Central Franconian: Furrel
Gothic: ğ†ğŒ¿ğŒ²ğŒ»ğƒÂ m (fugls)
Greek: Ï€Î¿Ï…Î»Î¯Â (el)Â n (poulÃ­), Ï€Ï„Î·Î½ÏŒÂ (el)Â n (ptinÃ³)
Ancient: á½„ÏÎ½Î¹Ï‚Â f (Ã³rnis), á½„ÏÎ½ÎµÎ¿Î½Â n (Ã³rneon), Ï€ÎµÏ„ÎµÎ¹Î½ÏŒÎ½Â n (peteinÃ³n)
Greenlandic: timmiaq
GuaranÃ­: guyraÂ (gn)
Gujarati: àªªàª¨àª–àª¿àª¦ (pankhid)
Guugu Yimidhirr: dyidyirr
Hadza: please add this translation if you can
Haitian Creole: zwazo
Hausa: tsuntsuÂ (ha)
Hawaiian: manu
Hebrew: ×¦×™×¤×•×¨ \ ×¦Ö´×¤Ö¼×•Ö¹×¨â€Â (he)Â f (tsipÃ³r), ×¢×•Ö¹×£â€Â (he)Â m (of)
Hindi: à¤šà¤¿à¤¡à¤¼à¤¿à¤¯à¤¾Â (hi)Â f (ciá¹›iyÄ), à¤ªà¤‚à¤›à¥€Â (hi)Â f (paÃ±chÄ«), à¤ªà¤•à¥à¤·à¥€Â (hi)Â m (paká¹£Ä«), à¤ªà¤°à¤¨à¥à¤¦à¤¾Â (hi)Â m (parandÄ), à¤ªà¤–à¥‡à¤°à¥‚Â (hi)Â m (pakherÅ«)
Hopi: tsiro
Hungarian: madÃ¡rÂ (hu)
Hunsrik: FoghelÂ m
Iban: burong
Icelandic: fuglÂ (is)Â m
Ido: uceloÂ (io)
Igbo: nná»¥ná»¥Â (ig)
Indonesian: burungÂ (id)
Ingrian: lintu
Ingush: Ğ¾Ğ°Ğ»Ñ…Ğ°Ğ·Ğ°Ñ€ (oalxazar)
Interlingua: aveÂ (ia)
Inuktitut: á‘á–•á’¥áŠá–… (tingmiaq)
Iranun: papanuk
Irish: Ã©anÂ (ga)Â m
Old Irish: Ã©nÂ m
Istriot: uzaiÂ mÂ pl
Italian: uccelloÂ (it)Â m, pennutoÂ (it)Â m, volatileÂ (it)Â m
Iu Mien: norqc
Ivatan: manumanuk
Japanese: é³¥Â (ja) (ã¨ã‚Š, tori), é³¥é¡Â (ja) (ã¡ã‚‡ã†ã‚‹ã„, chÅrui) (taxonomic group)
Jarai: ÄÄ­m
Jarawa: noha
Javanese: manukÂ (jv)
Kabuverdianu: avi, ave
Kabyle: agá¸iá¸Â m, afruxÂ m
Kannada: à²¹à²•à³à²•à²¿Â (kn) (hakki), à²ªà²•à³à²·à²¿Â (kn) (paká¹£i)
Kapampangan: ayup
Karachay-Balkar: Ñ‡Ñ‹Ğ¿Ñ‡Ñ‹ĞºÑŠ (Ã§Ä±pÃ§Ä±q)
Karelian: lintu, lindu
Kashmiri: Ø¬Ø§Ù†Ø§ÙˆØ§Ø±â€ (jÄnÄvÄr)
Kashubian: ptÃ´chÂ m
Kazakh: Ò›Ò±ÑÂ (kk) (qÅ«s)
Ket: ĞºĞµÓˆĞ°ÑÑĞµĞ»ÑŒ
Khasi: sim
Khmer: á”á€áŸ’áŸá¸Â (km) (baksÉ™y)
Khoekhoe: anis
Kimaragang: tombolog
Koch: à¦¤à¦¾à¦‰ (tau)
Koho: sim
Kokborok: tok
Komi-Zyrian: Ğ»ÑĞ±Ğ°Ñ‡ (lebaÄ‡)
Kongo: nuni, ndeke
Korean: ìƒˆÂ (ko) (sae), ì¡°ë¥˜(é³¥é¡)Â (ko) (joryu) (taxonomic group)
Kriol: bed
Kurdish:
Central Kurdish: Ø¨Ø§ÚµÙ†Ø¯Û•â€Â (ckb) (ballinde), ØªÛ•ÛŒØ±â€ (teyr)
Northern Kurdish: firrindeÂ (ku), balindeÂ (ku), Ã§ivÃ®kÂ (ku), Ã§Ã»Ã§ikÂ (ku), teyrÂ (ku), tilÃ»rÂ (ku), terewÃ®lÂ (ku)
Kyrgyz: ĞºÑƒÑˆÂ (ky) (kuÅŸ)
Ladino: ave, haveÂ f, pÃ¡Å¡aro, pÃ¡Å¾aro, pÃ¡jaro, pÃ¡saroÂ m
Lakota: ziÅ‹tkÃ¡la
Lao: àº™àº»àºÂ (lo) (nok), àº›àº±àºàºªàºµ (pak sÄ«), àº›àº±àºàºªàº² (pak sÄ), àº›àº±àºàº‚àºµ (pak khÄ«)
Latgalian: putnys
Latin: avisÂ (la)Â f, volucerÂ m
Latvian: putnsÂ (lv)Â m
Ledo Kaili: tonji
Lezgi: ĞºÑŠÑƒÑˆ (qÌ„uÅ¡), Ğ½ÑƒÑŒĞºÓ (nÃ¼á¸³)
Ligurian: Ã¶xÃ©lloÂ m
Lingala: ndeke
Lithuanian: paukÅ¡tisÂ (lt)Â m, paukÅ¡tÄ—Â f
Lombard: usellÂ (lmo)
Low German:
Dutch Low Saxon: vogelÂ (nds)
German Low German: VagelÂ (nds)Â m, VogelÂ (nds)Â m, PiepmatzÂ m (child's language)
Loxicha Zapotec: please add this translation if you can
LÃ¼: á¦·á¦“á§… (nok)
Luganda: ekinyonyi
Luxembourgish: VugelÂ m, VullÂ (lb)Â m
Macedonian: Ğ¿Ñ‚Ğ¸Ñ†Ğ°Â f (ptica)
Magahi: ğ‘‚£ğ‘‚’ğ‘‚¹ğ‘‚“ğ‘‚² (pacchÄ«), ğ‘‚ğ‘‚ (khag), ğ‘‚’ğ‘‚±ğ‘‚šğ‘‚† (ciá¹›aÄ«)
Maguindanao: papanuk
Mahican: tschÃ¨chtschis
Maithili: à¤šà¤¿à¤¡à¤¼à¥ˆ (ciá¹›aÉ¨)
Makasae: olo
Malagasy: voronaÂ (mg)
Malay: burungÂ (ms), manukÂ (ms) (obsolete)
Malayalam: à´ªà´•àµà´·à´¿Â (ml) (paká¹£i), à´•à´¿à´³à´¿Â (ml) (kiá¸·i), à´ªà´±à´µÂ (ml) (paá¹Ÿava)
Maltese: gÄ§asfurÂ m
Manchu: á¡¤á  á °á¡¥á   (gasha)
Manx: ushagÂ (gv)Â m
Maori: manuÂ (mi)
Maranao: papanok
Marathi: à¤ªà¤•à¥à¤·à¥€Â (mr) (paká¹£Ä«)
Mari:
Eastern Mari: ĞºĞ°Ğ¹Ñ‹Ğº (kajyk)
Western Mari: ĞºĞµĞº (kek)
Maricopa: chyer
Mariupol Greek: Ğ¿Ğ»Ñ‹Â n (ply)
MbyÃ¡ GuaranÃ­: guyra
Mi'kmaq: jipji'jÂ anim, sisipÂ anim
Middle Dutch: vogele
Middle English: fowel
Minangkabau: buruangÂ (min)
Mirandese: pÃ¡ixaroÂ m, abeÂ f
MÃ²cheno: vouglÂ m
Moksha: Ğ½Ğ°Ñ€Ğ¼Ğ¾Ğ½ÑŒ (narmoÅ„)
Mon: please add this translation if you can
Mongolian:
Cyrillic: ÑˆÑƒĞ²ÑƒÑƒÂ (mn) (Å¡uvuu)
Mongolian: á °á ¢á ªá  á ­á ¤ (sibaÉ£u)
Montagnais: pineshish
Mori Bawah: manu
Muong: chim
Mwani: nyuni
Nahuatl:
Central: tototl
Central Huasteca: tototl
Classical: tototl
Highland Puebla: totot
Western Huasteca: tototl
Nanai: Ğ³Ğ°ÑĞ°
Nanticoke: piss-seeques
Navajo: tsÃ­dii
Neapolitan: aucielloÂ m
Negidal: Ğ´ÑÒ“Ó£ (dÉ™É£Ä«)
Nepali: à¤šà¤°à¤¾ (carÄ)
Newar: à¤à¤‚à¤—à¤ƒ (jhaá¹ƒga:)
Nganasan: Ñ‚Ó™Ğ¸Ğ±Ó™Ó™ (terdee), tÃ¤ibÃ¤Ã¤
Ngazidja Comorian: nuniÂ class 9/10, nyunyiÂ class 9/10
Ngunawal: budyanÂ pl
Nivkh: Ğ¿Ñ‹Ğ¹ÓˆĞ° (pÉ™jÅ‹a)
Nkonya: obubwi
Nogai: ĞºÑƒÑ (kus)
Norman: mouissaonÂ m (Guernsey), ouaÃ®sÃ©Â m (Jersey)
North Frisian:
FÃ¶hr-Amrum: fÃ¶gelÂ m
Mooring: fÃ¶Ã¶gelÂ m
Northern Sami: loddi
Northern Thai: á¨¶á©«á© á¨  (nok)
Norwegian:
BokmÃ¥l: fuglÂ (no)Â m
Nynorsk: fuglÂ (nn)Â m
Nuer: dit
Nupe: elÃº
Occitan: aucÃ¨lÂ (oc)Â m (Lengadocian), aucÃ¨uÂ (oc)Â m (AuvernhÃ s, Lemosin, ProvenÃ§au), ausÃ¨thÂ (oc)Â m (Gascon)
Ojibwe: bineshiinh
Okinawan: é³¥ (ã¨ã…ã„, tui)
Old Church Slavonic:
Cyrillic: Ğ¿ÑŠÑ‚Ğ¸Ñ†Ğ°Â f (pÅ­tica)
Old Dutch: fogalÂ m, vogalÂ m
Old East Slavic: Ğ¿ÑŠÑ‚Ğ¸Ñ†Ğ°Â f (pÅ­tica), Ğ¿Ñ‚Ğ°Ñ…ÑŠÂ m (ptaxÅ­), Ğ¿Ñ‚Ğ°ĞºÑŠÂ m (ptakÅ­), Ğ¿ÑŠÑ‚Ğ¸Ñ‡ÑŒÂ f (pÅ­tiÄÄ­)
Old English: fugolÂ (ang)Â m
Old French: oiselÂ m
Old Javanese: manuk
Old Kannada: à²ªà²•à³à²•à²¿ (pakki)
Old Norse: foglÂ m, fuglÂ m
Old Prussian: pippelis
Old Turkic: ğ°´ğ°†ğ°½â€ (qusÂ¹ /â quÅ¡â /)
Oriya: à¬ªà¬•à­à¬·à­€Â (or) (pÃ´ká¹£i), à¬šà¬¢à¬¼à­‡à¬‡Â (or) (cÃ´á¹›hei)
Oromo: shimbiroÂ (om)
Ossetian: Ğ¼Ğ°Ñ€Ğ³ÑŠ (marÇ§)
Ottoman Turkish: Ù‚ÙˆØ´â€ (kuÅŸ)
Pali: sakuá¹‡aÂ m, pakkhÄ«Â m, vihagaÂ m
Pashto: Ù…Ø±ØºÙ‡â€Â f (marÇ§a)
Pennsylvania German: Voggel
Penobscot: sips
Persian: Ù¾ÙØ±ÙÙ†Ø¯ÙÙ‡â€Â (fa) (parande), Ù…ÙØ±Øºâ€Â (fa) (morÄŸ)
Piedmontese: oselÂ m
Pipil: tutut
Pitjantjatjara: tjuá¸»pu
Plautdietsch: VoagelÂ (nds)Â n
Polish: ptakÂ (pl)Â mÂ anim
Portuguese: pÃ¡ssaroÂ (pt)Â m, aveÂ (pt)Â f
Potawatomi: pnÃ©shi
Powhatan: tshehip
Punjabi: à¨ªà©°à¨–à©€ (paá¹…khÄ«), à¨ªà©°à¨›à©€Â m (paÃ±chÄ«)
Quechua: pisqu, pisgo
Rabha: à¦¤ (tÃ³)
Rajasthani: please add this translation if you can
Rakhine: please add this translation if you can
Rapa Nui: manu
Rohingya: faik
Romagnol: uÈ™Ã«lÂ m
Romani: Ä‡irikloÂ m, Ä‡irikliÂ f
Romanian: pasÄƒreÂ (ro)Â f
Romansch: utschÃ¨Â m (Rumantsch Grischun, Puter, Vallader), utschiÂ m (Sursilvan, Sutsilvan), utschelÂ m (Surmiran)
Russian: Ğ¿Ñ‚Ğ¸ÌÑ†Ğ°Â (ru)Â f (ptÃ­ca), Ğ¿Ñ‚Ğ°ÌÑˆĞºĞ°Â (ru)Â f (ptÃ¡Å¡ka), Ğ¿Ñ‚Ğ°ÌÑ…Â (ru)Â m (ptÃ¡x) (obsolete), Ğ¿Ñ‚Ğ°ÌÑ…Ğ°Â (ru)Â f (ptÃ¡xa) (colloquial), Ğ¿Ğ¾ÌÑ‚ĞºĞ°Â (ru)Â f (pÃ³tka) (dialectal)
Rusyn: Ğ¿Ñ‚Ğ°Ñ…Â m (ptax)
Rwanda-Rundi: inyoniÂ class 9/10, iki-guruka
S'gaw Karen: á€‘á€­á£á€º (há¹­ohÌ€)
Saek: à¸™à¹‡à¸­à¸
Samoan: manu
Sangisari: Ù…Ø±Øº (merq)
Sango: ndekeÂ (sg)
Sanskrit: à¤µà¤¿Â (sa)Â m (vi), à¤ªà¤•à¥à¤·à¤¿à¤¨à¥Â (sa)Â m (paká¹£in)
Santali: á±ªá±®á±¬á±® (ceá¹‡e)
Sardinian: pigioni, pilloni, pizone
Scots: bird
Scottish Gaelic: eunÂ (gd)Â m
Sebop: juwit
Semai: cep
Serbo-Croatian:
Cyrillic: Ğ¿Ñ‚Ğ¸ÌÑ†Ğ°Â f
Roman: ptÈ‰caÂ (sh)Â f
Shan: á¼á€°áµá€ºá‚‰Â (shn) (ná¹µÌ‚uk)
Shoshone: huchu
Sichuan Yi: please add this translation if you can
Sicilian: acedduÂ (scn)Â m
Sidamo: ceÊ¼a
Sikkimese: please add this translation if you can
Sindhi: Ù¾ÙÚ©ÙÙŠâ€
Sinhalese: à¶´à¶šà·Šà·‚à·’à¶ºà·Â (si) (paká¹£iyÄ), à¶šà·”à¶»à·”à¶½à·Šâ€à¶½à· (kurullÄ)
Slovak: vtÃ¡kÂ (sk)Â m
Slovene: ptiÄÂ (sl)Â m, pticaÂ (sl)Â f
Somali: shimbirÂ (so)
Sorbian:
Lower Sorbian: ptaÅ¡kÂ m
Upper Sorbian: ptaÄkÂ m
Sotho: nonyanaÂ (st)
Spanish: pÃ¡jaroÂ (es)Â m, aveÂ (es)Â f
Sumerian: ğ’„· (/â muÅ¡enâ /)
Sundanese: manukÂ (su)
Svan: áƒ›áƒ”áƒáƒÌˆÌ„áƒ  (meá¹—È«r), áƒ›áƒ”áƒáƒ•áƒ”Ì„áƒ  (meá¹—vÄ“r)
Swahili: ndegeÂ (sw)Â class 9/10
Swedish: fÃ¥gelÂ (sv)Â c
Sylheti: ê ™ê £ê ˆê ¤ (fakÃ­)
Tabasaran: Ğ³ÑŠÑƒÑˆ (Ä¡uÅ¡)
Tagalog: ibonÂ (tl)
Tahitian: manu
Tai Dam: êª¶êª™êª€
Tai NÃ¼a: please add this translation if you can
Tajik: Ğ¿Ğ°Ñ€Ñ€Ğ°Ğ½Ğ´Ğ°Â (tg) (parranda)
Tajio: mamanuk
Talysh:
Asalemi: Ù¾Ø±Ù†Ø¯Ù‡â€ (paranda)
Tamil: à®ªà®±à®µà¯ˆÂ (ta) (paá¹Ÿavai)
Taos: cÃ¬wyuâ€™Ãºna
Tarifit: ajá¸iá¸Â m
Tatar: ĞºĞ¾ÑˆÂ (tt) (qoÅŸ)
Tausug: manuk-manuk
Telugu: à°ªà°•à±à°·à°¿Â (te) (paká¹£i), à°µà°¿à°¹à°‚à°—à°®à±Â (te) (vihaá¹…gamu), à°ªà°¿à°Ÿà±à°ŸÂ (te) (piá¹­á¹­a)
Ternate: namo
Tetum: manu, manu-fuik
Thai: à¸™à¸Â (th) (nÃ³k), à¸›à¸±à¸à¸©à¸²Â (th) (bpÃ k-sÇa)
Tibetan: à½–à¾± (bya)
Tigrinya: á‹‘áÂ (ti) (Ê¿uf), áŒ­áˆ©Â (ti) (ÄÌ£É™ru)
Timugon Murut: susuit
Tiwa: tu
Tok Pisin: pisinÂ (tpi)
Tokelauan: manu
Tongan: manupuna
Tswana: nonyane
Tulu: à²ªà²•à³à²•à²¿ (pakki)
Tundra Nenets: Ñ‚Ğ¸Ñ€Ñ‚Ñ (tirtya)
TupinambÃ¡: gÃ»yrÃ¡
Turkish: kuÅŸÂ (tr)
Turkmen: guÅŸÂ (tk)
Tuvan: ĞºÑƒÑˆ (kuÅŸ)
Tzotzil: mut
Udi: ĞºÑŠÑƒÑˆ (qÌ‡uÅ¡)
Udmurt: Ğ¿Ğ°Ğ¿Ğ° (papa)
Ugaritic: ğ“ğ•ğ— (Ê¿á¹£r), ğ•ğ”ğ— (á¹£pr)
Ukrainian: Ğ¿Ñ‚Ğ°Ñ…Â (uk)Â m (ptax), Ğ¿Ñ‚Ğ¸ÌÑ†ÑÂ f (ptÃ½cja) (used as food)
Urdu: Ú†ÙÚ‘Ù’ÛŒØ§â€Â f (ciá¹›iyÄ), Ù¾ÙÙ†Ù’Ú†Ú¾ÛŒâ€Â f (panÌ„chÄ«), Ù¾ÙÚ©Ù’Ø´ÛŒâ€Â m (paká¹£Ä«), Ù¾ÙØ±ÙÙ†Ù’Ø¯ÙÛâ€Â m (parindÄ), Ù¾ÙÚ©Ú¾ÛŒØ±Ùˆâ€Â m (pakhÄ“rÅ«)
Uyghur: Ù‚Û‡Ø´â€Â (ug) (qush)
Uzbek: qushÂ (uz)
Venetian: oseoÂ m
Vietnamese: chimÂ (vi)
Vilamovian: fÈ«guÅ‚Â m
VolapÃ¼k: bÃ¶dÂ (vo)
VÃµro: tsirk
Votic: lintu
Walloon: oujheaÂ (wa), moxhonÂ (wa)Â m
Wardaman: jigjig
Welsh: aderynÂ (cy)Â m, adarÂ (cy)Â mÂ pl, ednÂ f, ednodÂ fÂ pl
West Coast Bajau: memanuk, manuk-manuk
West Frisian: fÃ»gelÂ (fy)
Western Panjabi: Ù¾Ù†Ú†Ú¾ÛŒâ€Â (pnb)Â m (pnchhÄ«), Ù¾Ø±Ù†Ø¯Ûâ€ (parindÄ)
White Hmong: noog
Wolof: piccÂ (wo)
Xhosa: intaka
Yakan: please add this translation if you can
Yakkha: à¤¨à¥â€à¤µà¤¾à¤•
Yakut: ĞºÓ©Ñ‚Ó©Ñ€Ğ´Ó©Ñ€ (kÃ¶tÃ¶rdÃ¶r), Ñ‡Ñ‹Ñ‹Ñ‡Ğ°Ğ°Ñ… (cÄ±Ä±caaq), ĞºÓ©Ñ‚Ó©Ñ€ (kÃ¶tÃ¶r)
Yiddish: ×¤Ö¿×•×™×’×œâ€Â m (foygl)
Yidgha: Ø·ÙˆØ·ÛŒâ€
Yoruba: áº¹yáº¹
Yucatec Maya: chÊ¼Ã­ichÊ¼
Yup'ik: yaqulek
Zazaki: perrende, mÄ±riÃ§Ä±k
Zealandic: veugelÂ m
Zhuang: roeg
Zulu: inyoniÂ (zu)Â class 9/10
Zuni: wotsana
ÇƒKung: tsaba
person
Chichonyi-Chidzihana-Chikauma: mutu
French: oiseauÂ (fr)Â m
German: VogelÂ (de)Â m, TypÂ (de)Â m (colloquial)
Greek: Ï„ÏÏ€Î¿Ï‚Â (el)Â m (tÃ½pos)
Italian: tipoÂ (it)Â m
Persian: Ø¬ÛŒÚ¯ÙØ±â€Â (fa) (jigar)
Slovene: tiÄÂ m (colloquial)
Swahili: ndegeÂ (sw)
woman
Arabic:
Egyptian Arabic: Ù…Ø²Ø©â€Â f (mozza)
Aragonese: mozetaÂ f
Armenian: Õ®Õ«Õ¿Â (hy) (cit)
Breton: polezÂ (br)Â f
Bulgarian: Ğ¼Ğ¾Ğ¼Ğ¸Ñ‡ĞµÂ (bg)Â n (momiÄe)
Catalan: noiaÂ (ca)Â f
Chichonyi-Chidzihana-Chikauma: muche
Dutch: grietÂ (nl)Â f
Esperanto: bubinoÂ f
Estonian: tibi
Faroese: sprundÂ n
Finnish: tipuÂ (fi)
French: nanaÂ (fr)Â f, minetteÂ (fr)Â f, gonzesseÂ (fr)Â f, meufÂ (fr)Â f
Galician: moza
German: SchnitteÂ (de)Â f, BrautÂ (de)Â f, PerleÂ (de)Â f, MiezeÂ (de)Â f
Greek: ÎºÎ¿ÏÎºÎ»Î±Â (el)Â f (koÃºkla), Î³ÎºÏŒÎ¼ÎµÎ½Î±Â (el)Â f (gkÃ³mena)
GuaranÃ­: kuÃ±aÂ (gn)
Indonesian: cewekÂ (id)
Interlingua: feminaÂ (ia)
Italian: bambolaÂ (it)Â f
Norwegian:
BokmÃ¥l: rypeÂ (no)Â f
Persian: Ø²ÙÛŒØ¯â€Â (fa) (zeyd)
Portuguese: raparigaÂ (pt)Â f (Portugal), moÃ§aÂ (pt)Â f (Brazil), gataÂ (pt)Â f
Russian: Ğ±Ğ°Ğ±Ñ‘Ğ½ĞºĞ°Â (ru)Â f (babjÃ³nka) (slang), Ñ‚Ñ‘Ğ»ĞºĞ°Â (ru)Â f (tjÃ³lka)
Slovak: ÄajkaÂ (sk)
Spanish: muchachaÂ (es)Â f, chicaÂ (es)Â f
Swahili: ndegeÂ (sw)
Swedish: brudÂ (sv)Â c
Telugu: à°šà°¿à°²à±à°•Â (te) (ciluka), à°ªà°¿à°Ÿà±à°ŸÂ (te) (piá¹­á¹­a)
Tok Pisin: meri
TupinambÃ¡: kunhÃ£
VolapÃ¼k: vomÂ (vo)Â f
Yiddish: ××™×™×“×œâ€Â f (meydl)
girlfriend
Bulgarian: Ğ³Ğ°ÌĞ´Ğ¶ĞµÂ (bg)Â n (gÃ¡dÅ¾e)
French: nanaÂ (fr)Â f, gonzesseÂ (fr)Â f, pouleÂ (fr)Â f, meufÂ (fr)Â f, femmeÂ (fr)Â f
Greek: Î³ÎºÏŒÎ¼ÎµÎ½Î±Â (el)Â f (gkÃ³mena) (slang)
Persian: Ø¯ÙˆØ³Øªâ€ŒØ¯ÙØ®ØªÙØ±â€Â (fa) (dust-doxtar)
Spanish: noviaÂ (es)Â f
vulgar hand gesture
Bulgarian: ÑÑ€ĞµÌĞ´ĞµĞ½ Ğ¿Ñ€ÑŠÑÑ‚Â m (srÃ©den prÇst)
French: doigt dâ€™honneurÂ (fr)Â m
German: StinkefingerÂ (de)Â m
Italian: dito d'onoreÂ m
Latin: digitus impudicusÂ m
Luxembourgish: bÃ©ise FangerÂ m
Polish: Å›rodkowy palecÂ m, fakÂ (pl)Â m
Portuguese: bananaÂ (pt)Â f
Russian: ÑÑ€ĞµÌĞ´Ğ½Ğ¸Ğ¹ Ğ¿Ğ°ÌĞ»ĞµÑ†Â (ru)Â m (srÃ©dnij pÃ¡lec) (middle finger), Ñ„Ğ°ĞºÂ (ru)Â m (fak)
penis
French: oiseauÂ (fr)Â m
See also[edit]
birb
burd
chirp
ornithic
ornithology
squawk
tweet
Appendix: Animals
Appendix:Gestures/middle finger
Verb[edit]
bird (third-person singular simple present birds, present participle birding, simple past and past participle birded)
(intransitive) To observe or identify wild birds in their natural environment.
(intransitive) To catch or shoot birds; to hunt birds.
(intransitive, figurative) To seek for game or plunder; to thieve.
1610 (first performance), Ben[jamin] Jonson, The Alchemist, London:  [â€¦]  Thomas Snodham, for Walter Burre, and are to be sold by Iohn Stepneth,Â [â€¦], published 1612, â†’OCLC; reprinted Menston, Yorkshire: The Scolar Press, 1970, â†’OCLC, (please specify the GB page), (please specify the scene number in lowercase Roman numerals):MAMMON: These day-owls.SURLY: That are birding in men's purses
(transitive, television) To transmit via satellite.
1995, David D. Pearce, Wary Partners: Diplomats and the Media, page 43:Unless the TV crew has its own flyaway, the locals can still defeat a story they couldn't prevent reporters from covering by cutting it off at the pass, when it is being birded through their facilities.
2012, Yoel Cohen, Media Diplomacy, page 127:After being sent by fast car to Tel Aviv the cassettes would be 'birded' by satellite to the USA and London.
Adjective[edit]
bird (comparative birdier, superlative birdiest)
(Canada, colloquial, of a school or university course) Able to be passed with very little work; having the nature of a bird course.
2020 October 16, illegalsalt, â€œThoughts on these bird coursesâ€, in Redditâ€[4], r/UTM:SOC100 isnâ€™t bird at all lol. But ANT101 is super easy & the prof (Dr. Sherry Fukuzawa) is amazing.
2022 June 17, ConradIsMyDaddy, â€œHow to Graduate from the University of Waterloo's Computer Science Program with the Least Amount of Effortâ€, in Redditâ€[5], r/uwaterloo:but admittedly, all the hours spent creating excel sheets optimizing my course plan, all the research finding the absolutely best professors, all the smart friends i made, all the alumni i contacted to collect crowdmarks of past exams, all the research i did finding the birdiest courses of all...... all of it was wayyyyyy more fun to me than just sitting down and studying like a normal kid. it was kind of just like playing a video game.
Etymology 2[edit]
Originally Cockney rhyming slang, shortened from bird-lime for "time".
Noun[edit]
bird (uncountable)
(slang) A prison sentence.
Heâ€™s doing bird.
Synonyms[edit]
(prison sentence): porridge, stretch, time
Translations[edit]
prison sentence
Verb[edit]
bird (third-person singular simple present birds, present participle birding, simple past and past participle birded)
(transitive, slang) To bring into prison, to roof.
2017, â€œNo Hookâ€, ZK & Digga D (lyrics), CDM (music):Free Criminal, he got birdedThat's a L but I know heâ€™ll firm itI was vexed when I heard that verdict
Translations[edit]
to bring into prison, to roof
French: tauleÂ (fr)Â f
German: (please verify) absitzen im Cafe Viereck
Swahili: (please verify) ndegeÂ (sw)
References[edit]
Douglas Harper (2001â€“2023), â€œbirdâ€, in Online Etymology Dictionary.
 bird on  Wikipedia.Wikipedia 
 Aves on  Wikimedia Commons.Wikimedia Commons 
 Aves on  Wikispecies.Wikispecies 
bird at OneLook Dictionary Search
Anagrams[edit]
drib
Retrieved from "https://en.wiktionary.org/w/index.php?title=bird&oldid=75873043"
Categories: Visual dictionaryEnglish 1-syllable wordsEnglish terms with IPA pronunciationEnglish terms with audio linksRhymes:English/ÉœË(É¹)dRhymes:English/ÉœË(É¹)d/1 syllableEnglish terms inherited from Middle EnglishEnglish terms derived from Middle EnglishEnglish terms inherited from Old EnglishEnglish terms derived from Old EnglishEnglish terms with unknown etymologiesEnglish lemmasEnglish nounsEnglish countable nounsEnglish terms with usage examplesEnglish terms with quotationsen:CookingEnglish slangBritish EnglishIrish EnglishEnglish terms with obsolete sensesAmerican EnglishCanadian EnglishPhilippine EnglishEnglish verbsEnglish intransitive verbsEnglish transitive verbsen:TelevisionEnglish adjectivesEnglish colloquialismsEnglish uncountable nounsen:Birdsen:VertebratesEnglish words derived through metathesisHidden categories: English entries with topic categories using raw markupEnglish entries with language name categories using raw markupQuotation templates to be cleanedRequests for translations into AitonTerms with manual transliterations different from the automated onesTerms with manual transliterations different from the automated ones/aiiRequests for translations into Western ChamTerms with redundant transliterationsTerms with redundant transliterations/yueTerms with redundant transliterations/cdoRequests for transliteration of Wu termsRequests for translations into HadzaRequests for translations into Loxicha ZapotecRequests for translations into MonRequests for translations into RajasthaniRequests for translations into RakhineRequests for translations into Sichuan YiRequests for translations into SikkimeseRequests for translations into Tai NÃ¼aTerms with manual transliterations different from the automated ones/yrkTerms with manual transliterations different from the automated ones/urRequests for translations into YakanRequests for review of German translationsRequests for review of Swahili translations
Navigation menu
Personal tools
Not logged inTalkContributionsCreate accountLog in
Namespaces
EntryDiscussion
English
Views
ReadEditHistory
More
Search
Navigation
Main PageCommunity portalPreferencesRequested entriesRecent changesRandom entryHelpGlossaryDonationsContact us
Tools
What links hereRelated changesUpload fileSpecial pagesPermanent linkPage informationCite this page
Print/export
Create a bookDownload as PDFPrintable version
In other languages
AfrikaansÃ†ngliscØ§Ù„Ø¹Ø±Ø¨ÙŠØ©AragonÃ©sAsturianuAzÉ™rbaycancaà¦¬à¦¾à¦‚à¦²à¦¾BÃ¢n-lÃ¢m-gÃºĞ‘ĞµĞ»Ğ°Ñ€ÑƒÑĞºĞ°ÑBosanskiBrezhonegCatalÃ ÄŒeÅ¡tinaCorsuCymraegDanskDeutschŞ‹Ş¨ŞˆŞ¬Ş€Ş¨Ş„Ş¦ŞŞ°EestiÎ•Î»Î»Î·Î½Î¹ÎºÎ¬EspaÃ±olEsperantoEuskaraÙØ§Ø±Ø³ÛŒFÃ¸roysktFranÃ§aisFryskGaeilgeGaelgGÃ idhligGalegoí•œêµ­ì–´Õ€Õ¡ÕµÕ¥Ö€Õ¥Õ¶à¤¹à¤¿à¤¨à¥à¤¦à¥€HrvatskiIdoBahasa Indonesiaáƒá“„á’ƒá‘á‘á‘¦ / inuktitutIsiZuluÃslenskaItalianoà²•à²¨à³à²¨à²¡áƒ¥áƒáƒ áƒ—áƒ£áƒšáƒ˜ÒšĞ°Ğ·Ğ°Ò›ÑˆĞ°KernowekKiswahiliKurdÃ®ĞšÑ‹Ñ€Ğ³Ñ‹Ğ·Ñ‡Ğ°àº¥àº²àº§LatinaLatvieÅ¡uLietuviÅ³LimburgsLombardMagyarĞœĞ°ĞºĞµĞ´Ğ¾Ğ½ÑĞºĞ¸Malagasyà´®à´²à´¯à´¾à´³à´‚MÄoriĞœĞ¾Ğ½Ğ³Ğ¾Ğ»á€™á€¼á€”á€ºá€™á€¬á€˜á€¬á€á€¬NÄhuatlNa Vosa VakavitiNederlandsæ—¥æœ¬èªNorskNorsk nynorskOccitanOromooOÊ»zbekcha / ÑĞ·Ğ±ĞµĞºÑ‡Ğ°à¨ªà©°à¨œà¨¾à¨¬à©€Ù¾ÚšØªÙˆá—á¶áŸá¶ááŸ’á˜áŸ‚ášTok PisinPolskiPortuguÃªsRomÃ¢nÄƒĞ ÑƒÑÑĞºĞ¸Ğ¹Gagana Samoaà¤¸à¤‚à¤¸à¥à¤•à¥ƒà¤¤à¤®à¥SÃ¤ngÃ¶ShqipSicilianuà·ƒà·’à¶‚à·„à¶½Simple EnglishSlovenÄinaSoomaaligaĞ¡Ñ€Ğ¿ÑĞºĞ¸ / srpskiSundaSuomiSvenskaà®¤à®®à®¿à®´à¯Ğ¢Ğ°Ñ‚Ğ°Ñ€Ñ‡Ğ° / tatarÃ§aà°¤à±†à°²à±à°—à±à¹„à¸—à¸¢á‰µáŒáˆ­áŠ›Ğ¢Ğ¾Ò·Ğ¸ĞºÓ£á£á³á©TÃ¼rkÃ§eTÃ¼rkmenÃ§eĞ£ĞºÑ€Ğ°Ñ—Ğ½ÑÑŒĞºĞ°Ø§Ø±Ø¯ÙˆØ¦Û‡ÙŠØºÛ‡Ø±Ú†Û• / UyghurcheVÃ¨netoTiáº¿ng Viá»‡tVolapÃ¼kWalonç²µèªä¸­æ–‡
 This page was last edited on 30 August 2023, at 23:41.
Definitions and other text are available under the Creative Commons Attribution-ShareAlike License; additional terms may apply. By using this site, you agree to the Terms of Use and Privacy Policy.
Privacy policy
AboutÂ Wiktionary
Disclaimers
Code of Conduct
Mobile view
Developers
Statistics
Cookie statement